[locate]
LANG=JP

[JP]
Copy=コピー(&C)
Editor=エディタで開く(&E)
Save...=保存(&S)...
Save and Continue=自動保存(&Z)
Snapshot Areas=選択エリア
  Undo=元に戻す(&Z)
  Redo=やり直す(&Y)
  All Select=全選択(&A)
  Clear Select=選択解除(&D)
  Pick Color Select=色選択(&P)
  Specify Size...=サイズ入力指定(&I)...
  SizeUp=領域を太らせる
  SizeDown=領域を細らせる
  Show Saved Areas=保存エリア一覧表示
  Info Copy=情報(&I)
Tools=ツール(&T)
  Screen Update=再読み込み(&U)
  Show Magnifying Glass=拡大鏡表示(&Z)
  Show SnapArea Size=サイズ表示(&S)
  Realtime Screen Mode=リアルタイム表示(&R)
  Popup picture=ポップウインドウ表示(&P)
Filter=フィルタ(&F)
  Reverse B/W=白黒反転(&W)
  Nega=ネガ反転(&N)
  Border Line=境界線表示(&B)
  Mouse Cursor=カーソル表示(&M)
Close This Menu=メニューを閉じる(&M)
Cancel=キャンセル(&C)

Snapshot=スナップショット(&S)
Self Timer...=時間差起動(&T)...
Option ...=オプション(&O)...
Open SaveFolder=自動保存先を開く(&F)
Help=ヘルプ(&H)
Exit Application=アプリを終了する(&X)

